# Known Suppliers Database for Fuzzy Matching
# Generated from existing validated filenames
# Format: CANONICAL_NAME|ALIAS1|ALIAS2|...

# Each line has the canonical name followed by known variations/aliases
# Used for fuzzy matching when extraction finds similar but not exact names

3SAT TECNOLOGIA
A S ACESSORIOS PARA VEICULOS|AS ACESSORIOS
ABDALLA TRUCK|ABDALLA TRUCK CENTER|ABDALLA TRUCK CENTER SERVICOS AUTOMOTIVOS
ADA ALVES MOREIRA|AGDA ALVES MOREIRA|AGDA ALVES MOREIRA BRITO
AGRIPARTS MAQUINAS|AGRIPARTS
AGRINOVA COMERCIO|AGRINOVA COMERCIO DE PECAS|AGRINOVA
AGRO BAGGIO|AGRO BAGGIO MAQUINAS|AGRO BAGGIO MAQUINAS AGRICOLAS
AGROFUTURO
AGUILERA AUTOPECAS|AGUILERA
ALIS
ANDERSON KLAYTON MIRANDA|ANDERSON K MIRANDA
ARAGUAIA AGRICOLA|ARAGUAIA
ASA MAQUINAS|ASA
ASTAM
AUTO ELETRICA SANTA CLARA|SANTA CLARA|AE SANTA CLARA LTDA|AE SANTA CLARA|AUTO ELETRICA
AUTO POSTO CHARRUA|POSTO CHARRUA|AUTO POSTO CHARRUA CC
B E B POWER AGRO|B&B POWER|BEB POWER AGRO
BRADESCO AUTO-RE|BRADESCO|BRADESCO SEGUROS
C WONDRACEK EIRELI|C WONDRACEK|WONDRACEK
CADORE BIDOIA|CADORE E BIDOIA|CADORE, BIDOIA|CADORE, BIDOIA E CIA|CADORE BIDOIA CIA
CALDATTO SERVICOS|CALDATTO
CASA DE CARNES CHAPECO|CASA CARNES CHAPECO
CASA DOS PNEUS|CASA PNEUS
CASE MAQUINAS|CASE
CEIFAGRO COMERCIO|CEIFAGRO COMERCIO PECAS|CEIFAGRO
CELIA VIANA ASSIS|CELIA V ASSIS
CELUPPI MAQUINAS|CELUPPI
CENCI E GREGORY|CENCI GREGORY
CENTRO OESTE
CERRADUS COMERCIO DE PNEUS|CERRADUS
CINTIA FABIANA RINCAO|CINTIA F RINCAO
CLEIDIANE FERREIRA
COELHOS TORNEARIA|COELHOS
COOPERATIVA DOS COTONICULTORES|COOPERATIVA COTONICULTORES
CWM SERVICOS HIDRAULICOS|CWM
DECORFIOS MATERIAIS ELETRICOS|DECORFIOS
DEL MORO|DELMORO
DIEGO CONCENTINO PELLEGRINI|DIEGO C PELLEGRINI
DIEGO COSTA SILVA
DIPECARR DIST PECAS|DIPECARR
F M SIQUEIRA|FM SIQUEIRA
F P VALDAMERI|FP VALDAMERI
FERNANDO MENIN
G F AUTO CENTER LTDA|GF AUTO CENTER|GF AUTO PECAS|GF AUTO ELETRICA|GF AUTO ELETRICA E MECANICA
GELSO PAULO LORENZI|GELSO LORENZI
GESIM AMBIENTAL|GESIM
GFD-JOAO LUIZ PELISARI|JOAO LUIZ PELISARI|GFD JOAO LUIZ|GFD
GLEIDSON TORNEARIA|GLEIDSON
GLOBO ROLAMENTOS|GLOBO
GT PNEUS|GT PNEUS E PECAS
GTL INDUSTRIA PECAS|GTL INDUTRIA COMERCIO|GTL
HBB CONTABILIDADE|HBB CONTABILIDADE GESTAO
HEISSLER COMERCIO|HEISSLER
IGLIKOSKI E IGLIKOSKI|IGLIKOSKI E IGLICOSKI|IGLIKOSKI|IGLICOSKI
INOVAGRO INSUMOS|INOVAGRO INSUMOS AGRICOLA|INOVAGRO
ISAAC A D P TRICHES|ISAAC TRICHES
JAILTON ASSIS
JK MERCADAO DE PECAS|JK MERCADAO PECAS|JK MERCADO PECAS|JK MERCADAO
JUCELIA GONCALVES|JUCELIA GONCALVES|JUCELIA
L A MACHADO|LA MACHADO
LAURIEEN NICOLY SILVA DREHE|LAURIEEN N SILVA
LEANDRO MAJOR NOGUEIRA
LEANDRO MOREIRA DOS SANTOS|LEANDRO M SANTOS
LEONARDO HENRIQUE A DE OLIVEIRA|LEONARDO H OLIVEIRA
LUCA COMERCIO DE FERRAGENS|LUCA COMERCIO|LUCA FERRAGENS
LUCAS MECANICA
LUCAS NETWORK|LUCAS METWORK
LUCIANE N MATEUS|LUCIANE MATEUS
M P S ALCANTARA|MPS ALCANTARA
M1V AGRICOLA|M1V
MANUTEC BOMBAS E COMPRESSORES|MANUTEC
MARCA RS COMERCIO|MARCA RS|MARCA RS COMERCIO DE COMBUSTIVEIS|MARCA RS COMBUSTIVEIS
MARCELI VESZ GAIATTO|MARCELI V GAIATTO
MARCIA LUCIO MARTINS
MAYKON DOUGLAS DA SILVA KANIESKI|MAYKON D KANIESKI
MCJ TAPECARIA|MCJ
METAL FER METALURGICA|METAL FER
MG VIDROS AUTOMOTIVOS|MG VIDROS
MIXTELAS
MONTANA ASSISTEC|MONTANA ASSISTENCIA|MONTANA
MUTUM DIESEL
MUTUM SERVICOS DE TECNOLOGIA|MUTUM SERVICOS
MV PECAS AGRICOLAS|MV PECAS
NBS COMERCIO|NBS COMERCIO E REPRESENTACOES
NORS EQUIPAMENTOS|NORS
NORTE MT ATACADISTA|NORTE MT
NOVO HORIZONTE|NOVO HORIZONTE COMBUSTIVEIS
O MONTAGNA E CIA|MONTAGNA
OESTE VEICULOS
PAPELARIA DO ESTUDANTE|PAPELARIA ESTUDANTE
PARANA MAT|PARANA MATERIAIS|PARANA MATERIAIS DE CONSTRUCAO
PITERI FERNANDES|PITERI FERNANDES E CIA
PLANTE BEM AGROPECUARIA|PLANTE BEM
PNEUACO LTDA|PNEUACO
PNEUZAO
POLATO SEMENTES|POLATO
POLIFILTRO
PRO INFO ENERGIA|PRO INFO ENERGIA INTERRUPTER|PRO INFO
PVG AGRONEGOCIO|PVG
R A MACORIN E CIA|RA MACORIN
R C COMERCIO COMBUSTIVEIS|RC COMERCIO|RC COMBUSTIVEIS
RAMOS MANUTENCOES|RAMOS|RAMOS MANUTENCOES AGRICOLAS
RB SOLUCOES EMPRESARIAIS|RB SOLUCOES
RECH AGRICOLA|RECH
RETIFICA RJ MOTORES|RETIFICA RJ
RODO NORTE|RODOBRAS|RODOBRAS COMBUSTIVEIS
SAFRA PECAS AGRICOLAS|SAFRA PECAS
SINOMAR AMARAL FRANCO|SINOMAR A FRANCO
SO EMBALAGENS
SOLUCOES FREIOS|SOLUCOES
SUPERNOVA COMERCIO|SUPERNOVA
TANIA M SCHINAIDER|TANIA SCHINAIDER
TCA PRESTADORA|TCA PRESTADORA DE SERVICOS
TELEMACO ANTONIO|TELEMACO
TERERE DU AGRO|TERERE
TETEU BORRACHARIA|TETEU BORRACHARIA E ACESSORIOS
TONELLO MATERIAIS CONSTRUCAO|TONELLO
TOTALSAFE ENGENHARIA|TOTALSAFE
TRANSPORTADORA CORANDI|CORANDI
TRATORMAX|TRATORMAX BERTI
TREVISOL|TREVISOL CIA
VALE SAFE EPIS|VALESAFE EPIS|VALESAFE
VIDRONORTE
VISIONNAIRE TECNOLOGIA|VISIONNAIRE
WESLEI A OLIVEIRA|WESLEI OLIVEIRA
WG AGRICULTURE|WG AGRICULTURE LTDA|WG
Z3 LAVA CAR|Z3 LAVA CAR E ESTETICA
